2 2 2 2 2 2 2 2 2 2 2 2 2 2 2 2
2 2 2 2 2 2 2 2 2 2 2 2 2 2 2 2
2 2 2 2 2 2 2 2 2 2 2 2 2 2 2 2
2 2 2 2 2 2 2 2 2 2 2 2 2 2 2 2
2 2 2 2 2 27 27 2  27 27 27 2 2 2 2 2
2 2 2 2 2 27 27 2  27 27 27 2 2 2 2 2
2 2 2 2 2 27 27 2  27 27 27 2 2 2 2 2
2 2 2 2 2 2  2  28 2  2  2  2 2 2 2 2
2 2 2 2 2 27 27 2  27 27 27 2 2 2 2 2
2 2 2 2 2 27 27 2  27 27 27 2 2 2 2 2
2 2 2 2 2 27 27 2  27 27 27 2 2 2 2 2
2 2 2 2 2 2 2 2 2 2 2 2 2 2 2 2
2 2 2 2 2 2 2 2 2 2 2 2 2 2 2 2
2 2 2 2 2 2 2 2 2 2 2 2 2 2 2 2
2 2 2 2 2 2 2 2 2 2 2 2 2 2 2 2
2 2 2 2 2 2 2 2 2 2 2 2 2 2 2 2